111111
100C01
10C011
1E00P1
111111