111111
100C01
100011
1E00P1
111111