111111
100C01
100011
1EE0P1
111111
111111
111111