111111
1C1EP1
100001
100001
111111
