1111111111111111111111111111111111111111111111111
11110000000000000000000000000000000000000000P0001
1111000000000000000000000000000000000000000000001
111100000000C000000000C00000000000000000000000001
1111000000000000000000000000000000000000000000001
11110000000C0000000000000000000000000000000000001
111100000000000000000000000C0000000000000C0000001
1111000000000000000000000000000000000000000000001
1111000000000000000000000000000000000000000000001
1111000000000000E00000000000000000000000000000001
1111111111111111111111111111111111111111111111111